NO textures/snake.xpm
EA textures/snake.xpm
SO textures/snake.xpm
WE textures/snake.xpm

C 0, 128, 128
F 50, 50, 50

111111111111111
100000000001111
100111110E01111
100000000001111
101111111100111
100000000000111
111111111111111
