NO textures/lavafull.xpm
EA textures/lavafull.xpm
SO textures/lavafull.xpm
WE textures/lavafull.xpm

C 255, 100, 0
F 50, 50, 50

1111111111
1000000001
100010W011
1010100011
1000000011
1111111111
